5 5
#E###
#...#
###.#
#...#
#X###
10 8
########
#....#.#
###....#
E.#.##.#
#....#.#
###..#.#
#...##.X
#..##..#
##.....#
########
5 5
#E###
#...#
###.#
#...#
#X###
10 8
########
#....#.#
###....#
E.#.##.#
#....#.#
###..#.#
#...##.X
#..##..#
##.....#
########
5 5
#E###
#...#
###.#
#...#
#X###